----------------------------------------------------------------------------------------------------------------------------
----H-----------------------------------------------------------------------------------------------------------------------
--------------------------------------------------------------------------------BBBBB-----B-----------B-----------B---------
-----------------------------------------------------------------------------B------------------B-----------B-----------B---
--------------------------------------------------------------------------B---------------B---------------------------------
------------------------------------BB-B-------------------B---B---B---B----------------------------------------------------
----------------------------------BBbb---B---------------B--------------------------------B---------------------------------
--------------------------------BBbbbb-----B-----------B--------------------------------------------------------------------
------------------------------BBbbbbbb-------B-------B------------------------------------B---------------------------------
----------------------------BBbbbbbbbb---------B---B------------------------------------------------------------------------
--------------------------BBbbbbbbbbbb-----------B----------------------------------------B---------------------------------
BBBBBBBBBBBBBBBBBBBBBBBBBBBBBBBBBBBBBBBBBBBBBBBBBBBBBBBBBBBBBBBBBBBBBBBBBBBBBBBBBBBBBBBBBBBBBBBBBBBBBBBBBBBBBBBBBBBBBBBBBBBB